
level= 1
width= 10
data=	0 0 0 0 0 0 0 0 0 0 
		1 1 1 1 1 1 0 0 0 0 
		1 2 1 1 1 1 1 0 0 0 
		1 1 0 0 1 1 1 0 0 0 
		0 0 0 0 1 1 0 0 0 0 
		0 0 0 0 1 1 1 1 1 1 
		0 0 0 0 1 1 1 1 3 1 
		0 0 0 0 0 0 0 1 1 1 
		0 0 0 0 0 0 0 0 0 0 
		0 0 0 0 0 0 0 0 0 0
intensity= 0.25 
light= 0 2 8 1   0.1 0.1 5 0.15
light= 5 2 4 0.1 1   0.1 5 0.15
light= 8 2 2 0.1 0.1 1   5 0.15
light= 4 2 6 0.1 0.1 1   5 0.15
light= 6 2 3 1   0.1 1   5 0.15
light= 2 2 6 1   1   0.1 5 0.15


level= 2
width= 10
data=	1 1 1 1 0 0 0 0 0 0 
		1 2 1 1 1 1 1 1 1 0 
		1 1 1 0 0 0 0 0 1 0 
		1 1 1 0 0 0 0 0 1 0 
		0 0 0 0 0 0 0 0 1 0 
		0 0 0 0 0 0 0 1 1 0 
		0 1 1 1 1 1 1 1 1 1 
		0 1 3 1 1 0 0 1 1 1
		0 1 1 1 0 0 0 1 1 1
		0 0 0 0 0 0 0 0 0 0
intensity= 0.25
light= 0 2 8 1   0.1 0.1 5 0.15
light= 5 2 4 0.1 1   0.1 5 0.15
light= 8 2 2 0.1 0.1 1   5 0.15
light= 4 2 6 0.1 0.1 1   5 0.15
light= 6 2 3 1   0.1 1   5 0.15
light= 2 2 6 1   1   0.1 5 0.15

level= 3
width= 15
data=	1 1 1 0 0 0 0 1 1 1 1 0 0 0 0 
		1 2 1 1 0 0 0 1 1 3 1 0 0 0 0
		1 1 1 1 0 0 0 1 1 1 1 0 0 0 0
		0 0 1 1 0 0 0 1 1 1 1 0 0 0 0
		0 0 1 0 0 0 0 1 0 0 1 0 0 0 0
		0 0 1 0 0 0 0 1 0 0 1 0 0 0 0
		0 0 1 1 0 0 1 1 0 0 1 0 0 0 0
		0 0 1 1 1 1 1 1 0 0 1 0 0 0 0
		0 1 1 1 0 0 0 0 0 1 1 0 0 0 0
		1 1 1 0 0 0 0 0 0 1 1 0 0 0 0
		1 1 1 0 0 0 0 0 0 1 1 0 0 0 0
		1 1 1 1 1 1 1 1 1 1 1 0 0 0 0
		0 0 0 0 0 0 0 0 0 0 0 0 0 0 0
		0 0 0 0 0 0 0 0 0 0 0 0 0 0 0
		0 0 0 0 0 0 0 0 0 0 0 0 0 0 0
intensity= 0.25
light= 0 2 8 1   0.1 0.1 5 0.15
light= 5 2 4 0.1 1   0.1 5 0.15
light= 8 2 2 0.1 0.1 1   5 0.15
light= 4 2 6 0.1 0.1 1   5 0.15
light= 6 2 3 1   0.1 1   5 0.15
light= 2 2 6 1   1   0.1 5 0.15
